*******************************
*S    *              *        *
****  *******  *******  *  ****
*     *     *  *        *  *  *
*  *  *  *  *  *  *******  *  *
*  *  *  *  *           *  *  *
****  *  ****  ****  *******  *
*        *  *     *     *     *
*  ****  *  *******  *  *  ****
*  *        *     *  *        *
*******  *  *  ****  *  ****  *
*  *     *           *  *    E*
*  *  *************************
*        *     *        *     *
****  *  *  *  *******  *  *  *
*     *     *  *  *     *  *  *
*  *  *******  *  ****  ****  *
*  *  *     *  *  *        *  *
*  ****  ****  *  ****  *  *  *
*        *              *     *
*******************************