*E********
* *
* *** *
* * * *
* * *** *
* * *
** S * *
* *
*********
*