*********************
*S  *       *       *
*** ******* * ***** *
*     *           * *
* * ***** *** * *****
* * *       * * * * *
* *** * ******* * * *
*     * *   *   *  S*
***** * *** * * * ***
* *   * *   * *     *
* * *** * ********* *
*     *   *         *
*** *********** * ***
*S      * *     * * *
***** *** ***** * * *
*   *   *     * *   *
*** ********* * *****
*                   *
*** * *** *** ***** *
*   *   * *      E* *
*********************
