*************************************************************
*S       *E *  *        *                 *     *     *     *
****  *  *  *  ****  *  *******  *******  *  *******  ****  *
*     *  *        *  *  *        *     *  *                 *
*  *  ****  *  *******  *  *  ****  **********  *******  ****
*  *  *  *  *        *     *     *     *  *     *        *  *
*  *  *  *  ****  ****  *******  *  ****  *  *******  ****  *
*  *  *     *        *  *           *           *     *  *  *
****  ****  ****  *******  ****  *************  ****  *  *  *
*     *  *  *           *  *           *  *  *  *           *
*  *  *  **********  *******  *******  *  *  ****  ****  ****
*  *  *                       *     *  *  *           *  *  *
*  ****  *************  **********  *  *  *  *  *  *  *  *  *
*     *  *        *           *     *  *     *  *  *  *     *
*  *  ****  ****  *******  ****  ****  *  *  *  ****  *******
*  *  *     *        *              *     *  *  *  *        *
*  *******  *******  *******  *******  *  ****  *  *  ****  *
*  *        *     *  *           *  *  *     *     *  *     *
*  *******  *  ****  *  ****  ****  ****  *  ****  ****  ****
*           *        *  *        *     *  *  *        *     *
*  *  *  ****  **********  **********  *******  *******  *  *
*  *  *     *        *        *     *     *           *  *  *
*  *  *  *  ****  ****************  *  *  ****  ****  ****  *
*  *  *  *  *     *        *  *        *  *     *        *  *
*  *************  ****  ****  *  *******  ****  ****  ****  *
*              *                 *  *              *     *  *
*  *************  *************  *  *******  *************  *
*     *        *  *     *     *  *  *  *     *           *  *
*  **********  *******  *  ****  *  *  *******  ****  ****  *
*  *  *  *        *     *     *           *  *  *        *  *
*  *  *  ****  *******  ****  *******  *  *  *******  *  *  *
*     *           *  *  *        *     *  *           *  *  *
*  ****  ****  *  *  *  *  *  *  ****  *******  *  *******  *
*  *  *  *     *     *  *  *  *  *     *        *        *  *
*  *  *  *  *  *  *  *  *  **********  *******  *************
*     *  *  *  *  *  *  *  *     *  *  *              *     *
****  *  ****  *  ****  *  ****  *  *  *  *  *  ****  *  *  *
*        *  *  *  *  *  *        *  *  *  *  *  *  *     *  *
****  ****  *  *  *  *  *  *  ****  *  *  *  ****  ****  ****
*           *  *           *        *     *        *        *
*************************************************************
